1
5 13
###########WW
##########B#W
P#########BGW
##########B#W
###########WW