1
5 13
###########WW
##########BWW
P########B#GW
##########BWW
###########WW